AGAIN	AH G EH N
AGAIN(2)	AH G EY N
CAN	K AE N
CAN(2)	K AH N
DAY	D EY
EVENING	IY V N IH NG
GOOD	G UH D
GOOD(2)	G IH D
GOODBYE	G UH D B AY
HELLO	HH AH L OW
HELLO(2)	HH EH L OW
LISA	L IY S AH
MORNING	M AO R N IH NG
REPEAT	R IH P IY T
REPEAT(2)	R IY P IY T
SEE	S IY
SORRY	S AA R IY
THANK	TH AE NG K
THANKS	TH AE NG K S
THAT	DH AE T
THAT(2)	DH AH T
YOU	Y UW
